+++++++++++++++++++++
+  +   +++++        +
+    ++++++++++      
+ +   ++  ++++ +++ ++
+ +   ++ ++    +++  +
+         ++  ++ +  +
+++++ + +     ++  + +
+++++ +++ + +  ++ + +
+         + + S++   +
+++++ + + + +     + +
+++++++++++++++++++++ 